"filename", "language", "Markdown", "Shell Script", "Makefile", "JavaScript", "comment", "blank", "total"
"/Users/shgopher/Desktop/family/GOFamily/.vuepress/config.js", "JavaScript", 0, 0, 0, -23, 23, 0, 0
"/Users/shgopher/Desktop/family/GOFamily/Makefile", "Makefile", 0, 0, 2, 0, 0, 0, 2
"/Users/shgopher/Desktop/family/GOFamily/README.md", "Markdown", 12, 0, 0, 0, 0, -2, 10
"/Users/shgopher/Desktop/family/GOFamily/lint.sh", "Shell Script", 0, 19, 0, 0, 15, 16, 50
"/Users/shgopher/Desktop/family/GOFamily/runtime/gmp/README.md", "Markdown", 1, 0, 0, 0, 10, 0, 11
"/Users/shgopher/Desktop/family/GOFamily/runtime/定时器/README.md", "Markdown", 0, 0, 0, 0, 0, 1, 1
"/Users/shgopher/Desktop/family/GOFamily/基础/helloWorld/README.md", "Markdown", 37, 0, 0, 0, 10, 11, 58
"/Users/shgopher/Desktop/family/GOFamily/基础/interface/README.md", "Markdown", 105, 0, 0, 0, 0, 18, 123
"/Users/shgopher/Desktop/family/GOFamily/基础/map/README.md", "Markdown", 2, 0, 0, 0, 0, 1, 3
"/Users/shgopher/Desktop/family/GOFamily/基础/slice/README.md", "Markdown", 268, 0, 0, 0, 0, 38, 306
"/Users/shgopher/Desktop/family/GOFamily/基础/string/README.md", "Markdown", 30, 0, 0, 0, 0, 3, 33
"/Users/shgopher/Desktop/family/GOFamily/基础/其他内容/README.md", "Markdown", 10, 0, 0, 0, 0, -3, 7
"/Users/shgopher/Desktop/family/GOFamily/基础/函数方法/0.md", "Markdown", 1, 0, 0, 0, 0, 0, 1
"/Users/shgopher/Desktop/family/GOFamily/基础/函数方法/4.md", "Markdown", 2, 0, 0, 0, 0, 2, 4
"/Users/shgopher/Desktop/family/GOFamily/基础/函数方法/7.md", "Markdown", 3, 0, 0, 0, 0, -1, 2
"/Users/shgopher/Desktop/family/GOFamily/基础/函数方法/README.md", "Markdown", 116, 0, 0, 0, 0, 11, 127
"/Users/shgopher/Desktop/family/GOFamily/基础/变量声明/README.md", "Markdown", 82, 0, 0, 0, 0, 8, 90
"/Users/shgopher/Desktop/family/GOFamily/基础/数字类型/README.md", "Markdown", 78, 0, 0, 0, 0, 43, 121
"/Users/shgopher/Desktop/family/GOFamily/基础/结构体/README.md", "Markdown", 77, 0, 0, 0, 0, 21, 98
"/Users/shgopher/Desktop/family/GOFamily/基础/逻辑和判断语句/README.md", "Markdown", 26, 0, 0, 0, 0, 7, 33
"/Users/shgopher/Desktop/family/GOFamily/基础/错误处理/README.md", "Markdown", 714, 0, 0, 0, 10, 132, 856
"/Users/shgopher/Desktop/family/GOFamily/工程/go web 编程/README.md", "Markdown", -5, 0, 0, 0, -10, 0, -15
"/Users/shgopher/Desktop/family/GOFamily/工程/goweb编程/README.md", "Markdown", 5, 0, 0, 0, 10, 0, 15
"/Users/shgopher/Desktop/family/GOFamily/工程/go标准库/README.md", "Markdown", 518, 0, 0, 0, 0, 31, 549
"/Users/shgopher/Desktop/family/GOFamily/工程/go编程范式/README.md", "Markdown", 36, 0, 0, 0, 10, 1, 47
"/Users/shgopher/Desktop/family/GOFamily/工程/go编程范式/k8s_visitor/README.md", "Markdown", 1, 0, 0, 0, 0, 0, 1
"/Users/shgopher/Desktop/family/GOFamily/工程/go编程范式/pipeline/README.md", "Markdown", 1, 0, 0, 0, 0, 0, 1
"/Users/shgopher/Desktop/family/GOFamily/工程/go编程范式/代理/README.md", "Markdown", 0, 0, 0, 0, 0, 1, 1
"/Users/shgopher/Desktop/family/GOFamily/工程/go编程范式/信号量/README.md", "Markdown", 0, 0, 0, 0, 0, 1, 1
"/Users/shgopher/Desktop/family/GOFamily/工程/go编程范式/创建者/README.md", "Markdown", 1, 0, 0, 0, 0, 2, 3
"/Users/shgopher/Desktop/family/GOFamily/工程/go编程范式/功能选项/README.md", "Markdown", 0, 0, 0, 0, 0, 1, 1
"/Users/shgopher/Desktop/family/GOFamily/工程/go编程范式/单例/README.md", "Markdown", 0, 0, 0, 0, 0, 1, 1
"/Users/shgopher/Desktop/family/GOFamily/工程/go编程范式/原型/README.md", "Markdown", 1, 0, 0, 0, 10, 0, 11
"/Users/shgopher/Desktop/family/GOFamily/工程/go编程范式/发布者订阅者/README.md", "Markdown", 0, 0, 0, 0, 0, 1, 1
"/Users/shgopher/Desktop/family/GOFamily/工程/go编程范式/定时函数/README.md", "Markdown", 0, 0, 0, 0, 0, 1, 1
"/Users/shgopher/Desktop/family/GOFamily/工程/go编程范式/对象池/README.md", "Markdown", 0, 0, 0, 0, 0, 1, 1
"/Users/shgopher/Desktop/family/GOFamily/工程/go编程范式/工厂方法/README.md", "Markdown", 0, 0, 0, 0, 0, 1, 1
"/Users/shgopher/Desktop/family/GOFamily/工程/go编程范式/并行/README.md", "Markdown", 0, 0, 0, 0, 0, 1, 1
"/Users/shgopher/Desktop/family/GOFamily/工程/go编程范式/扇入/README.md", "Markdown", 0, 0, 0, 0, 0, 1, 1
"/Users/shgopher/Desktop/family/GOFamily/工程/go编程范式/扇出/README.md", "Markdown", 0, 0, 0, 0, 0, 1, 1
"/Users/shgopher/Desktop/family/GOFamily/工程/go编程范式/断路器/README.md", "Markdown", 0, 0, 0, 0, 0, 1, 1
"/Users/shgopher/Desktop/family/GOFamily/工程/go编程范式/有界并行/README.md", "Markdown", 0, 0, 0, 0, 0, 1, 1
"/Users/shgopher/Desktop/family/GOFamily/工程/go编程范式/生成器/README.md", "Markdown", 0, 0, 0, 0, 0, 1, 1
"/Users/shgopher/Desktop/family/GOFamily/工程/go编程范式/策略/README.md", "Markdown", 0, 0, 0, 0, 0, 1, 1
"/Users/shgopher/Desktop/family/GOFamily/工程/go编程范式/装饰器/README.md", "Markdown", 0, 0, 0, 0, 0, 1, 1
"/Users/shgopher/Desktop/family/GOFamily/工程/go编程范式/观察者/README.md", "Markdown", 0, 0, 0, 0, 0, 1, 1
"/Users/shgopher/Desktop/family/GOFamily/工程/go语言规范/README.md", "Markdown", 2, 0, 0, 0, 10, 0, 12
"/Users/shgopher/Desktop/family/GOFamily/工程/go面试题/README.md", "Markdown", 8, 0, 0, 0, 0, 0, 8
"/Users/shgopher/Desktop/family/GOFamily/工程/go面试题/architect.md", "Markdown", 0, 0, 0, 0, 0, 1, 1
"/Users/shgopher/Desktop/family/GOFamily/工程/go面试题/intermediate.md", "Markdown", 0, 0, 0, 0, 0, 1, 1
"/Users/shgopher/Desktop/family/GOFamily/工程/go面试题/primary.md", "Markdown", 0, 0, 0, 0, 0, 1, 1
"/Users/shgopher/Desktop/family/GOFamily/工程/go面试题/senior.md", "Markdown", 0, 0, 0, 0, 0, 1, 1
"/Users/shgopher/Desktop/family/GOFamily/工程/go面试题/中高级go面试题一.md", "Markdown", 28, 0, 0, 0, 10, 1, 39
"/Users/shgopher/Desktop/family/GOFamily/工程/wasm/README.md", "Markdown", 4, 0, 0, 0, 0, -1, 3
"/Users/shgopher/Desktop/family/GOFamily/工程/包及其构建工具/README.md", "Markdown", 20, 0, 0, 0, 0, 14, 34
"/Users/shgopher/Desktop/family/GOFamily/工程/错误处理/README.md", "Markdown", -66, 0, 0, 0, -10, -12, -88
"/Users/shgopher/Desktop/family/GOFamily/并发/README.md", "Markdown", -1, 0, 0, 0, 10, 0, 9
"/Users/shgopher/Desktop/family/GOFamily/并发/atomic/README.md", "Markdown", 50, 0, 0, 0, 10, 22, 82
"/Users/shgopher/Desktop/family/GOFamily/并发/channel/README.md", "Markdown", 1097, 0, 0, 0, 0, 206, 1303
"/Users/shgopher/Desktop/family/GOFamily/并发/context/README.md", "Markdown", 208, 0, 0, 0, 0, 46, 254
"/Users/shgopher/Desktop/family/GOFamily/并发/内存模型/README.md", "Markdown", 2, 0, 0, 0, 0, -2, 0
"/Users/shgopher/Desktop/family/GOFamily/并发/同步原语/README.md", "Markdown", 1025, 0, 0, 0, 10, 253, 1288
"/Users/shgopher/Desktop/family/GOFamily/并发/定时器/README.md", "Markdown", -1, 0, 0, 0, 0, 0, -1
"/Users/shgopher/Desktop/family/GOFamily/并发/并发原语/README.md", "Markdown", -3, 0, 0, 0, -10, -2, -15
"/Users/shgopher/Desktop/family/GOFamily/并发/并发模型/README.md", "Markdown", 93, 0, 0, 0, 0, 20, 113
"/Users/shgopher/Desktop/family/GOFamily/编译器/README.md", "Markdown", 26, 0, 0, 0, 10, 0, 36
"/Users/shgopher/Desktop/family/GOFamily/编译器/gc/README.md", "Markdown", 20, 0, 0, 0, 10, 5, 35
"/Users/shgopher/Desktop/family/GOFamily/编译器/gccgo/README.md", "Markdown", 10, 0, 0, 0, 0, 5, 15
"/Users/shgopher/Desktop/family/GOFamily/编译器/llvm/README.md", "Markdown", 37, 0, 0, 0, 10, 14, 61
"Total", "-", 4681, 19, 2, -23, 148, 930, 5757