"filename", "language", "JavaScript", "Markdown", "comment", "blank", "total"
"/Users/shgopher/Desktop/family/GOFamily/.vuepress/config.js", "JavaScript", 15, 0, 0, 2, 17
"/Users/shgopher/Desktop/family/GOFamily/README.md", "Markdown", 0, 6, 0, 0, 6
"/Users/shgopher/Desktop/family/GOFamily/基础/slice/README.md", "Markdown", 0, -1, 0, 0, -1
"/Users/shgopher/Desktop/family/GOFamily/基础/string/README.md", "Markdown", 0, 1, 0, 1, 2
"/Users/shgopher/Desktop/family/GOFamily/基础/作用域/README.md", "Markdown", 0, 1, 0, 0, 1
"/Users/shgopher/Desktop/family/GOFamily/基础/求值顺序/README.md", "Markdown", 0, 6, 0, 3, 9
"/Users/shgopher/Desktop/family/GOFamily/基础/逻辑和判断语句/README.md", "Markdown", 0, 5, 0, -1, 4
"/Users/shgopher/Desktop/family/GOFamily/工程/README.md", "Markdown", 0, 1, 0, 0, 1
"/Users/shgopher/Desktop/family/GOFamily/工程/golint/README.md", "Markdown", 0, 0, 0, -1, -1
"/Users/shgopher/Desktop/family/GOFamily/工程/go语言规范/README.md", "Markdown", 0, 5, 0, 1, 6
"/Users/shgopher/Desktop/family/GOFamily/工程/log/README.md", "Markdown", 0, 4, 0, 3, 7
"/Users/shgopher/Desktop/family/GOFamily/工程/vuln/README.md", "Markdown", 0, -4, 0, -4, -8
"/Users/shgopher/Desktop/family/GOFamily/工程/代码检查/README.md", "Markdown", 0, 110, 0, 11, 121
"/Users/shgopher/Desktop/family/GOFamily/工程/包及其构建工具/README.md", "Markdown", 0, 202, 0, 55, 257
"/Users/shgopher/Desktop/family/GOFamily/工程/命令/README.md", "Markdown", 0, 13, 0, 0, 13
"/Users/shgopher/Desktop/family/GOFamily/工程/性能剖析/README.md", "Markdown", 0, -2, 0, -1, -3
"/Users/shgopher/Desktop/family/GOFamily/工程/测试/README.md", "Markdown", 0, 2, 0, 0, 2
"/Users/shgopher/Desktop/family/GOFamily/工程/系统信号的处理/README.md", "Markdown", 0, 1, 0, 0, 1
"/Users/shgopher/Desktop/family/GOFamily/并发/内存模型/README.md", "Markdown", 0, 226, 0, 73, 299
"/Users/shgopher/Desktop/family/GOFamily/并发/定时器/README.md", "Markdown", 0, 1, 0, 0, 1
"/Users/shgopher/Desktop/family/GOFamily/并发/并发模型/README.md", "Markdown", 0, 9, 0, 0, 9
"Total", "-", 15, 586, 0, 142, 743