"filename", "language", "JavaScript", "Markdown", "XML", "comment", "blank", "total"
"/Users/shgopher/Desktop/family/GOFamily/.vuepress/config.js", "JavaScript", -250, 0, 0, 0, -4, -254
"/Users/shgopher/Desktop/family/GOFamily/README.md", "Markdown", 0, 12, 0, 0, 2, 14
"/Users/shgopher/Desktop/family/GOFamily/changelog.config.js", "JavaScript", 70, 0, 0, 10, 0, 80
"/Users/shgopher/Desktop/family/GOFamily/runtime/netpool/README.md", "Markdown", 0, 3, 0, 10, -1, 12
"/Users/shgopher/Desktop/family/GOFamily/runtime/定时器/README.md", "Markdown", 0, 0, 0, 0, -1, -1
"/Users/shgopher/Desktop/family/GOFamily/基础/interface/README.md", "Markdown", 0, 753, 0, 10, 191, 954
"/Users/shgopher/Desktop/family/GOFamily/基础/关键字/README.md", "Markdown", 0, -4, 0, 0, -1, -5
"/Users/shgopher/Desktop/family/GOFamily/基础/函数方法/0.md", "Markdown", 0, 64, 0, 10, 17, 91
"/Users/shgopher/Desktop/family/GOFamily/基础/函数方法/1.md", "Markdown", 0, 64, 0, 10, 12, 86
"/Users/shgopher/Desktop/family/GOFamily/基础/函数方法/2.md", "Markdown", 0, 2, 0, 10, 1, 13
"/Users/shgopher/Desktop/family/GOFamily/基础/函数方法/3.md", "Markdown", 0, 56, 0, 10, 9, 75
"/Users/shgopher/Desktop/family/GOFamily/基础/函数方法/4.md", "Markdown", 0, 78, 0, 10, 10, 98
"/Users/shgopher/Desktop/family/GOFamily/基础/函数方法/5.md", "Markdown", 0, 48, 0, 10, 11, 69
"/Users/shgopher/Desktop/family/GOFamily/基础/函数方法/6.md", "Markdown", 0, 1, 0, 10, 2, 13
"/Users/shgopher/Desktop/family/GOFamily/基础/函数方法/7.md", "Markdown", 0, 138, 0, 0, 29, 167
"/Users/shgopher/Desktop/family/GOFamily/基础/函数方法/README.md", "Markdown", 0, 1138, 0, 0, 271, 1409
"/Users/shgopher/Desktop/family/GOFamily/基础/函数方法/gofunc.svg", "XML", 0, 0, 3, 1, 0, 4
"/Users/shgopher/Desktop/family/GOFamily/基础/变量声明/README.md", "Markdown", 0, 1, 0, 0, 1, 2
"/Users/shgopher/Desktop/family/GOFamily/基础/常量声明/README.md", "Markdown", 0, 30, 0, 0, 7, 37
"/Users/shgopher/Desktop/family/GOFamily/基础/泛型/README.md", "Markdown", 0, 19, 0, 0, -2, 17
"/Users/shgopher/Desktop/family/GOFamily/基础/结构体/README.md", "Markdown", 0, 229, 0, 10, 37, 276
"/Users/shgopher/Desktop/family/GOFamily/工程/go web 编程/README.md", "Markdown", 0, 5, 0, 10, 0, 15
"/Users/shgopher/Desktop/family/GOFamily/工程/web/README.md", "Markdown", 0, -4, 0, 0, 0, -4
"/Users/shgopher/Desktop/family/GOFamily/工程/代码检查/README.md", "Markdown", 0, 6, 0, 0, 4, 10
"/Users/shgopher/Desktop/family/GOFamily/工程/反射/README.md", "Markdown", 0, 1, 0, 10, 1, 12
"/Users/shgopher/Desktop/family/GOFamily/工程/错误处理/README.md", "Markdown", 0, 63, 0, 10, 12, 85
"/Users/shgopher/Desktop/family/GOFamily/并发/README.md", "Markdown", 0, 1, 0, 0, 0, 1
"/Users/shgopher/Desktop/family/GOFamily/并发/并发原语/README.md", "Markdown", 0, 2, 0, 10, 1, 13
"/Users/shgopher/Desktop/family/GOFamily/并发/并发模型/README.md", "Markdown", 0, 1, 0, 10, 1, 12
"Total", "-", -180, 2707, 3, 161, 610, 3301