"filename", "language", "Markdown", "JavaScript", "comment", "blank", "total"
"/Users/shgopher/Desktop/family/GOFamily/.vuepress/config.js", "JavaScript", 0, -19, 19, 0, 0
"/Users/shgopher/Desktop/family/GOFamily/README.md", "Markdown", -11, 0, 0, 0, -11
"/Users/shgopher/Desktop/family/GOFamily/基础/interface/README.md", "Markdown", 6, 0, 0, 1, 7
"/Users/shgopher/Desktop/family/GOFamily/基础/map/README.md", "Markdown", 4, 0, 0, 0, 4
"/Users/shgopher/Desktop/family/GOFamily/基础/作用域/README.md", "Markdown", 128, 0, 10, 29, 167
"/Users/shgopher/Desktop/family/GOFamily/基础/其他内容/README.md", "Markdown", 0, 0, 0, 1, 1
"/Users/shgopher/Desktop/family/GOFamily/基础/函数方法/README.md", "Markdown", 21, 0, 0, 7, 28
"/Users/shgopher/Desktop/family/GOFamily/基础/求值顺序/README.md", "Markdown", 56, 0, 0, 17, 73
"/Users/shgopher/Desktop/family/GOFamily/基础/逻辑和判断语句/README.md", "Markdown", 176, 0, 10, 57, 243
"/Users/shgopher/Desktop/family/GOFamily/工程/go标准库/README.md", "Markdown", 3, 0, 0, 2, 5
"/Users/shgopher/Desktop/family/GOFamily/工程/坑/README.md", "Markdown", 2, 0, 0, 1, 3
"/Users/shgopher/Desktop/family/GOFamily/工程/字符编码/README.md", "Markdown", 1, 0, 0, 0, 1
"/Users/shgopher/Desktop/family/GOFamily/工程/读写模型/README.md", "Markdown", 1, 0, 0, 0, 1
"/Users/shgopher/Desktop/family/GOFamily/并发/context/README.md", "Markdown", 1, 0, 10, 0, 11
"/Users/shgopher/Desktop/family/GOFamily/并发/并发原语/README.md", "Markdown", 1, 0, 0, 0, 1
"Total", "-", 389, -19, 49, 115, 534